


NO 				            ./texture/north_texture.xpm
			
			SO ./texture/south_texture.xpm  		

	
		EA   	  ./texture/east_texture.xpm 		    
 
 WE     	  ./texture/west_texture.xpm           


 	 	 	 	 F      27,32,11    
	
C  	3,2,1q


C 11,22,11



        0
        1111111111111111111111111
        101000000000000000000001
        10110000011100000001111 1
        10010000000111111101111001
111111111011000001110000000000001
100000000011000001110111111111111
11110111111111011100000010001

11110111111111011101010000001
11000000110101011100000010001
10000000000000001100000010001
1000         0001101010010001
110000011110101011111011110N0111
11110111 1110101 101111010001
11111111 1111111 111111111111