NO ./textures/white_64.png
SO ./textures/desktop.png
WE ./textures/white_64.png
EA ./textures/desktop.png

F 220,100,0
C 225,30,0

111111111111111111111111111111
1000000000110000000000001          
1011000001110000000000001        
10010000000000000000000011111111111
111111111111000001110000000000011 Cub21
100000001 1100000111011111111111 
11110111111111011100000010001
11110111111111011101010010001
11000000110101011100000010001
10001000000000001100000010001
10000000000000001101010010001
11000001110101011111011110N0111
11110111 1110101 101111010001111
11111111 1111111 111111111111