


NO 				            ./texture/stone_wall.png
			
			SO ./texture/wolf.png 		

	
		EA   	  ./texture/brick.png 		    
 
 WE     	  ./texture/standstone.png


 	 	 	 	 F      235,165,0    
	

C 255,0,0

        111111111111111111011111111111
1000000000110000000000001
      1011000001110000000000001
10010000000000000000000011111111111
111111111111000001110000000000011
100000001 D100000111011111111111
11110111111111111100000010001
11110111111111011101010010001
11000000110101011100000010001
10001000000000001100000010001
11110111 1110101 101111010S01111
10000000000000001101010010001
1100000111010101111101111000111
11111111 1111111 111111111111
