


NO 				            ./texture/stone_wall.png
			
			SO ./texture/wolf.png  		

	
		EA   	  ./texture/brick.png 		    
 
 WE     	  ./texture/standstone.png


 	 	 	 	 F      27,32,11    
	
C  	3,2,1q


C 11,22,11

11111111111111111111111111111111111111111
1 1   1            1     1              1
1 1 1 11111 11111 1 111111111 111 1111111
1   1 1     1       1         1       1 1
111 111 11111 111 11111 111 111 1 11111 1
1 1   1 1 1     1     1   1 1   1   1   1
1 1 11111 1 11111 1 11111 1 1 111 1 111 1
1 1   1 1       1 1   1 1 1 1   1 1     1
1 111 1 1 111 1 11111 1 1 1 1 1 111 1 1 1
1       1   1 1 1 1       1 1 1 1   1 1 1
1 1 111 1 111 111 1 111 1 111 1 11111 1 1
1 1   1     1   1   1 1 1     1 1     1 1
1 111 111111111 1 1 1 11111 1111111 111 1
1   1 1 1 1     1 1 1     1 1   1     1 1
1 11111 1 11111 111 111 11111 111111111 1
1     1    1      N       1 1 1   1 1   1
111 1 1 1111111 111 11111111111 1 1 1 111
1   1     1   1   1 1 1 1       1 1 1   1
11111 1 111 1 1111111 1 111 11111 1 111 1
1     1   1 1 1 1 1 1   1     1 1   1   1
111 1 111 111 1 1 1 1 111 11111 1111111 1
1 1 1   1 1     1 1         1   1   1   1
1 1 1 111 1 111 1 1 111 1111111 111 1 111
1   1 1       1   1   1 1 1       1 1   1
111111111 1111111 1 1 111 1 1 111 1 1 1 1
1 1       1       1 1   1 1 1   1 1 1 1 1
11111 1 1 111111111 11111 11111 111 1 111
1     1 1 1         1   1   1 1         1
1111111 1 111 111 1 1 111 111 1 1 11111 1
1 1   1 1 1   1   1 1   1       1 1 1   1
1 111 1 1 1 1111111 111 111 11111 1 11111
1   1 1 1 1 1     1     1     1         1
111 1 111 111 1111111 1 1 1 1111111 11111
1     1 1   1   1     1   1 1 1       1 1
1 11111 1 11111 11111 11111 1 111 111 1 1
1   1   1 1 1 1     1 1       1     1 1 1
111 1 1 111 1 1 111 1 1 11111111111 111 1
1 1 1 1 1   1   1   1 1   1             1
1 1 1 1 1 1 111 1 111 1 111 111 111 1 1 1
1     1   1     1     1 1   1     1 1 1D1
11111111111111111111111111111111111111111
