


NO 				            ./texture/stone_wall.png
			
			SO ./texture/wolf.png

	
		EA   	  ./texture/brick.png 		    
 
 WE     	  ./texture/standstone.png


 	 	 	 	 F      27,32,11    
	
C  	3,2,1q


C 11,22,11

1111111111111111111111111
1000000000000000000100001
1001000000000000000000001
1001000000000000001000001
10010000000N0000001000001
1001000000100000001000001
1001000000000000001000001
1001000000001000001000001
1111111111111111111111111