


NO 				            ./texture/stone_wall.png
			
			SO ./texture/wolf.png 		

	
		EA   	  ./texture/brick.png 		    
 
 WE     	  ./texture/standstone.png


 	 	 	 	 F      235,165,0    
	

C 255,0,0

        111111111111111111011111111111
1000000000110000000000001

